longwave_radiance	isotropic_longwave_radiance_in_air
shortwave_radiance	isotropic_shortwave_radiance_in_air
mole_fraction_of_o3_in_air	mole_fraction_of_ozone_in_air
product_of_northward_wind_and_specific_humdity	product_of_northward_wind_and_specific_humidity
electromagnetic_wavelength	radiation_wavelength
specific_potential_energy	specific_gravitational_potential_energy
atmosphere_surface_drag_coefficient_of_heat	surface_drag_coefficient_for_heat_in_air
atmosphere_surface_drag_coefficient_of_momentum	surface_drag_coefficient_for_momentum_in_air
atmosphere_surface_drag_coefficient	surface_drag_coefficient_in_air
swell_wave_period	sea_surface_swell_wave_period
wind_wave_period	sea_surface_wind_wave_period
mass_fraction_of_convective_condensed_water_in_air	mass_fraction_of_convective_cloud_condensed_water_in_air
mass_fraction_of_o3_in_air	mass_fraction_of_ozone_in_air
sea_surface_wave_frequency	wave_frequency
northward_eliassen_palm_flux	northward_eliassen_palm_flux_in_air
northward_heat_flux_due_to_eddy_advection	northward_heat_flux_in_air_due_to_eddy_advection
upward_eliassen_palm_flux	upward_eliassen_palm_flux_in_air
upward_flux_of_eastward_momentum_due_to_nonorographic_eastward_gravity_waves	upward_eastward_momentum_flux_in_air_due_to_nonorographic_eastward_gravity_waves
upward_flux_of_eastward_momentum_due_to_nonorographic_westward_gravity_waves	upward_eastward_momentum_flux_in_air_due_to_nonorographic_westward_gravity_waves
upward_flux_of_eastward_momentum_due_to_orographic_gravity_waves	upward_eastward_momentum_flux_in_air_due_to_orographic_gravity_waves
water_flux_into_ocean	water_flux_into_sea_water
wind_mixing_energy_flux_into_ocean	wind_mixing_energy_flux_into_sea_water
surface_net_downward_radiative_flux_where_land	surface_net_downward_radiative_flux
surface_upward_sensible_heat_flux_where_sea	surface_upward_sensible_heat_flux
moles_of_carbon_monoxide_in_atmosphere	atmosphere_moles_of_carbon_monoxide
moles_of_methane_in_atmosphere	atmosphere_moles_of_methane
moles_of_methyl_bromide_in_atmosphere	atmosphere_moles_of_methyl_bromide
moles_of_methyl_chloride_in_atmosphere	atmosphere_moles_of_methyl_chloride
moles_of_molecular_hydrogen_in_atmosphere	atmosphere_moles_of_molecular_hydrogen
moles_of_nitrous_oxide_in_atmosphere	atmosphere_moles_of_nitrous_oxide
concentration_of_suspended_matter_in_sea_water	mass_concentration_of_suspended_matter_in_sea_water
mole_concentration_of_mesozooplankton_in_sea_water_expressed_as_nitrogen	mole_concentration_of_mesozooplankton_expressed_as_nitrogen_in_sea_water
mole_concentration_of_microzooplankton_in_sea_water_expressed_as_nitrogen	mole_concentration_of_microzooplankton_expressed_as_nitrogen_in_sea_water
mole_concentration_of_organic_detritus_in_sea_water_expressed_as_nitrogen	mole_concentration_of_organic_detritus_expressed_as_nitrogen_in_sea_water
mole_concentration_of_organic_detritus_in_sea_water_expressed_as_silicon	mole_concentration_of_organic_detritus_expressed_as_silicon_in_sea_water
ocean_volume	sea_water_volume
tendency_of_moles_of_methyl_bromide_in_atmosphere	tendency_of_atmosphere_moles_of_methyl_bromide
tendency_of_moles_of_methyl_chloride_in_atmosphere	tendency_of_atmosphere_moles_of_methyl_chloride
tendency_of_moles_of_molecular_hydrogen_in_atmosphere	tendency_of_atmosphere_moles_of_molecular_hydrogen
tendency_of_moles_of_nitrous_oxide_in_atmosphere	tendency_of_atmosphere_moles_of_nitrous_oxide
tendency_of_moles_of_carbon_monoxide_in_middle_atmosphere	tendency_of_middle_atmosphere_moles_of_carbon_monoxide
tendency_of_moles_of_methane_in_middle_atmosphere	tendency_of_middle_atmosphere_moles_of_methane
tendency_of_moles_of_methyl_bromide_in_middle_atmosphere	tendency_of_middle_atmosphere_moles_of_methyl_bromide
tendency_of_moles_of_methyl_chloride_in_middle_atmosphere	tendency_of_middle_atmosphere_moles_of_methyl_chloride
tendency_of_moles_of_molecular_hydrogen_in_middle_atmosphere	tendency_of_middle_atmosphere_moles_of_molecular_hydrogen
tendency_of_moles_of_carbon_monoxide_in_troposphere	tendency_of_troposphere_moles_of_carbon_monoxide
tendency_of_moles_of_methane_in_troposphere	tendency_of_troposphere_moles_of_methane
tendency_of_moles_of_methyl_bromide_in_troposphere	tendency_of_troposphere_moles_of_methyl_bromide
tendency_of_moles_of_methyl_chloride_in_troposphere	tendency_of_troposphere_moles_of_methyl_chloride
tendency_of_moles_of_molecular_hydrogen_in_troposphere	tendency_of_troposphere_moles_of_molecular_hydrogen
atmosphere_convective_mass_flux	atmosphere_net_upward_convective_mass_flux
eastward_water_vapor_flux	eastward_water_vapor_flux_in_air
dissipation_in_atmosphere_boundary_layer	kinetic_energy_dissipation_in_atmosphere_boundary_layer
lwe_large_scale_snowfall_rate	lwe_stratiform_snowfall_rate
lwe_thickness_of_large_scale_snowfall_amount	lwe_thickness_of_stratiform_snowfall_amount
northward_water_vapor_flux	northward_water_vapor_flux_in_air
large_scale_rainfall_amount	stratiform_rainfall_amount
large_scale_rainfall_flux	stratiform_rainfall_flux
large_scale_rainfall_rate	stratiform_rainfall_rate
large_scale_snowfall_amount	stratiform_snowfall_amount
large_scale_snowfall_flux	stratiform_snowfall_flux
thickness_of_large_scale_rainfall_amount	thickness_of_stratiform_rainfall_amount
thickness_of_large_scale_snowfall_amount	thickness_of_stratiform_snowfall_amount
atmosphere_cloud_condensed_water_content	atmosphere_mass_content_of_cloud_condensed_water
atmosphere_cloud_ice_content	atmosphere_mass_content_of_cloud_ice
atmosphere_convective_cloud_condensed_water_content	atmosphere_mass_content_of_convective_cloud_condensed_water
atmosphere_water_vapor_content	atmosphere_mass_content_of_water_vapor
surface_carbon_dioxide_mole_flux	surface_downward_mole_flux_of_carbon_dioxide
atmosphere_so4_content	atmosphere_mass_content_of_sulfate
atmosphere_sulfate_content	atmosphere_mass_content_of_sulfate
change_over_time_in_atmosphere_water_content_due_to_advection	change_over_time_in_atmosphere_mass_content_of_water_due_to_advection
change_over_time_in_atmospheric_water_content_due_to_advection	change_over_time_in_atmosphere_mass_content_of_water_due_to_advection
lwe_thickness_of_atmosphere_water_vapor_content	lwe_thickness_of_atmosphere_mass_content_of_water_vapor
cloud_condensed_water_content_of_atmosphere_layer	mass_content_of_cloud_condensed_water_in_atmosphere_layer
cloud_ice_content_of_atmosphere_layer	mass_content_of_cloud_ice_in_atmosphere_layer
water_content_of_atmosphere_layer	mass_content_of_water_in_atmosphere_layer
water_vapor_content_of_atmosphere_layer	mass_content_of_water_vapor_in_atmosphere_layer
tendency_of_atmosphere_water_content_due_to_advection	tendency_of_atmosphere_mass_content_of_water_due_to_advection
tendency_of_atmosphere_water_vapor_content	tendency_of_atmosphere_mass_content_of_water_vapor
tendency_of_atmosphere_water_vapor_content_due_to_convection	tendency_of_atmosphere_mass_content_of_water_vapor_due_to_convection
tendency_of_atmosphere_water_vapor_content_due_to_deep_convection	tendency_of_atmosphere_mass_content_of_water_vapor_due_to_deep_convection
tendency_of_atmosphere_water_vapor_content_due_to_shallow_convection	tendency_of_atmosphere_mass_content_of_water_vapor_due_to_shallow_convection
tendency_of_atmosphere_water_vapor_content_due_to_turbulence	tendency_of_atmosphere_mass_content_of_water_vapor_due_to_turbulence
tendency_of_water_vapor_content_of_atmosphere_layer	tendency_of_mass_content_of_water_vapor_in_atmosphere_layer
tendency_of_water_vapor_content_of_atmosphere_layer_due_to_convection	tendency_of_mass_content_of_water_vapor_in_atmosphere_layer_due_to_convection
tendency_of_water_vapor_content_of_atmosphere_layer_due_to_deep_convection	tendency_of_mass_content_of_water_vapor_in_atmosphere_layer_due_to_deep_convection
tendency_of_water_vapor_content_of_atmosphere_layer_due_to_shallow_convection	tendency_of_mass_content_of_water_vapor_in_atmosphere_layer_due_to_shallow_convection
tendency_of_water_vapor_content_of_atmosphere_layer_due_to_turbulence	tendency_of_mass_content_of_water_vapor_in_atmosphere_layer_due_to_turbulence
equivalent_thickness_at_stp_of_atmosphere_o3_content	equivalent_thickness_at_stp_of_atmosphere_ozone_content
x_sea_water_velocity	sea_water_x_velocity
y_sea_water_velocity	sea_water_y_velocity
grid_eastward_wind	x_wind
grid_northward_wind	y_wind
tendency_of_atmosphere_water_vapor_content_due_to_advection	tendency_of_atmosphere_mass_content_of_water_vapor_due_to_advection
land_ice_surface_specific_mass_balance	land_ice_surface_specific_mass_balance_rate
land_ice_lwe_surface_specific_mass_balance	land_ice_lwe_surface_specific_mass_balance_rate
isotropic_spectral_radiance_in_air	isotropic_radiance_per_unit_wavelength_in_air
spectral_radiance	isotropic_radiance_per_unit_wavelength_in_air
omnidirectional_spectral_spherical_irradiance_in_sea_water	omnidirectional_spherical_irradiance_per_unit_wavelength_in_sea_water
chlorophyll_concentration_in_sea_water	mass_concentration_of_chlorophyll_in_sea_water
concentration_of_chlorophyll_in_sea_water	mass_concentration_of_chlorophyll_in_sea_water
atmosphere_specific_convective_available_potential_energy	atmosphere_convective_available_potential_energy
specific_convective_available_potential_energy	atmosphere_convective_available_potential_energy
gross_primary_productivity_of_carbon	gross_primary_productivity_of_biomass_expressed_as_carbon
net_primary_productivity_of_carbon	net_primary_productivity_of_biomass_expressed_as_carbon
net_primary_productivity_of_carbon_accumulated_in_leaves	net_primary_productivity_of_biomass_expressed_as_carbon_accumulated_in_leaves
net_primary_productivity_of_carbon_accumulated_in_roots	net_primary_productivity_of_biomass_expressed_as_carbon_accumulated_in_roots
net_primary_productivity_of_carbon_accumulated_in_wood	net_primary_productivity_of_biomass_expressed_as_carbon_accumulated_in_wood
atmosphere_mass_content_of_particulate_organic_matter_dry_aerosol	atmosphere_mass_content_of_particulate_organic_matter_dry_aerosol_particles
atmosphere_mass_content_of_primary_particulate_organic_matter_dry_aerosol	atmosphere_mass_content_of_primary_particulate_organic_matter_dry_aerosol_particles
mass_fraction_of_particulate_organic_matter_dry_aerosol_in_air	mass_fraction_of_particulate_organic_matter_dry_aerosol_particles_in_air
mass_fraction_of_primary_particulate_organic_matter_dry_aerosol_in_air	mass_fraction_of_primary_particulate_organic_matter_dry_aerosol_particles_in_air
tendency_of_atmosphere_mass_content_of_particulate_organic_matter_dry_aerosol_due_to_dry_deposition	tendency_of_atmosphere_mass_content_of_particulate_organic_matter_dry_aerosol_particles_due_to_dry_deposition
tendency_of_atmosphere_mass_content_of_particulate_organic_matter_dry_aerosol_due_to_gravitational_settling	tendency_of_atmosphere_mass_content_of_particulate_organic_matter_dry_aerosol_particles_due_to_gravitational_settling
tendency_of_atmosphere_mass_content_of_particulate_organic_matter_dry_aerosol_due_to_turbulent_deposition	tendency_of_atmosphere_mass_content_of_particulate_organic_matter_dry_aerosol_particles_due_to_turbulent_deposition
tendency_of_atmosphere_mass_content_of_particulate_organic_matter_dry_aerosol_due_to_wet_deposition	tendency_of_atmosphere_mass_content_of_particulate_organic_matter_dry_aerosol_particles_due_to_wet_deposition
tendency_of_atmosphere_mass_content_of_primary_particulate_organic_matter_dry_aerosol_due_to_dry_deposition	tendency_of_atmosphere_mass_content_of_primary_particulate_organic_matter_dry_aerosol_particles_due_to_dry_deposition
tendency_of_atmosphere_mass_content_of_primary_particulate_organic_matter_dry_aerosol_due_to_wet_deposition	tendency_of_atmosphere_mass_content_of_primary_particulate_organic_matter_dry_aerosol_particles_due_to_wet_deposition
atmosphere_absorption_optical_thickness_due_to_ambient_aerosol	atmosphere_absorption_optical_thickness_due_to_ambient_aerosol_particles
aerosol_angstrom_exponent	angstrom_exponent_of_ambient_aerosol_in_air
atmosphere_absorption_optical_thickness_due_to_dust_ambient_aerosol	atmosphere_absorption_optical_thickness_due_to_dust_ambient_aerosol_particles
atmosphere_absorption_optical_thickness_due_to_particulate_organic_matter_ambient_aerosol	atmosphere_absorption_optical_thickness_due_to_particulate_organic_matter_ambient_aerosol_particles
atmosphere_absorption_optical_thickness_due_to_sulfate_ambient_aerosol	atmosphere_absorption_optical_thickness_due_to_sulfate_ambient_aerosol_particles
atmosphere_mass_content_of_ammonium_dry_aerosol	atmosphere_mass_content_of_ammonium_dry_aerosol_particles
atmosphere_mass_content_of_dust_dry_aerosol	atmosphere_mass_content_of_dust_dry_aerosol_particles
atmosphere_mass_content_of_mercury_dry_aerosol	atmosphere_mass_content_of_mercury_dry_aerosol_particles
atmosphere_mass_content_of_nitrate_dry_aerosol	atmosphere_mass_content_of_nitrate_dry_aerosol_particles
atmosphere_mass_content_of_nitric_acid_trihydrate_ambient_aerosol	atmosphere_mass_content_of_nitric_acid_trihydrate_ambient_aerosol_particles
atmosphere_mass_content_of_secondary_particulate_organic_matter_dry_aerosol	atmosphere_mass_content_of_secondary_particulate_organic_matter_dry_aerosol_particles
atmosphere_mass_content_of_sulfate_ambient_aerosol	atmosphere_mass_content_of_sulfate_ambient_aerosol_particles
atmosphere_content_of_sulfate_aerosol	atmosphere_mass_content_of_sulfate_ambient_aerosol_particles
atmosphere_mass_content_of_sulfate_dry_aerosol	atmosphere_mass_content_of_sulfate_dry_aerosol_particles
atmosphere_mass_content_of_water_in_ambient_aerosol	atmosphere_mass_content_of_water_in_ambient_aerosol_particles
atmosphere_moles_of_nitric_acid_trihydrate_ambient_aerosol	atmosphere_moles_of_nitric_acid_trihydrate_ambient_aerosol_particles
atmosphere_optical_thickness_due_to_ambient_aerosol	atmosphere_optical_thickness_due_to_ambient_aerosol_particles
atmosphere_optical_thickness_due_to_aerosol	atmosphere_optical_thickness_due_to_ambient_aerosol_particles
atmosphere_optical_thickness_due_to_dust_ambient_aerosol	atmosphere_optical_thickness_due_to_dust_ambient_aerosol_particles
atmosphere_optical_thickness_due_to_dust_dry_aerosol	atmosphere_optical_thickness_due_to_dust_dry_aerosol_particles
atmosphere_optical_thickness_due_to_particulate_organic_matter_ambient_aerosol	atmosphere_optical_thickness_due_to_particulate_organic_matter_ambient_aerosol_particles
mass_concentration_of_dust_dry_aerosol_in_air	mass_concentration_of_dust_dry_aerosol_particles_in_air
mass_concentration_of_coarse_mode_ambient_aerosol_in_air	mass_concentration_of_coarse_mode_ambient_aerosol_particles_in_air
mass_concentration_of_ammonium_dry_aerosol_in_air	mass_concentration_of_ammonium_dry_aerosol_particles_in_air
atmosphere_mass_content_of_sulfate_dry_aerosol_expressed_as_sulfur	atmosphere_mass_content_of_sulfate_dry_aerosol_particles_expressed_as_sulfur
atmosphere_mass_content_of_sulfate_expressed_as_sulfur_dry_aerosol	atmosphere_mass_content_of_sulfate_dry_aerosol_particles_expressed_as_sulfur
mass_concentration_of_primary_particulate_organic_matter_dry_aerosol_in_air	mass_concentration_of_primary_particulate_organic_matter_dry_aerosol_particles_in_air
mass_concentration_of_particulate_organic_matter_dry_aerosol_in_air	mass_concentration_of_particulate_organic_matter_dry_aerosol_particles_in_air
atmosphere_optical_thickness_due_to_water_in_ambient_aerosol	atmosphere_optical_thickness_due_to_water_in_ambient_aerosol_particles
mass_concentration_of_mercury_dry_aerosol_in_air	mass_concentration_of_mercury_dry_aerosol_particles_in_air
mass_concentration_of_nitrate_dry_aerosol_in_air	mass_concentration_of_nitrate_dry_aerosol_particles_in_air
mass_concentration_of_nitric_acid_trihydrate_ambient_aerosol_in_air	mass_concentration_of_nitric_acid_trihydrate_ambient_aerosol_particles_in_air
mass_concentration_of_secondary_particulate_organic_matter_dry_aerosol_in_air	mass_concentration_of_secondary_particulate_organic_matter_dry_aerosol_particles_in_air
mass_concentration_of_sulfate_ambient_aerosol_in_air	mass_concentration_of_sulfate_ambient_aerosol_particles_in_air
mass_concentration_of_sulfate_aerosol_in_air	mass_concentration_of_sulfate_ambient_aerosol_particles_in_air
mass_concentration_of_sulfate_dry_aerosol_in_air	mass_concentration_of_sulfate_dry_aerosol_particles_in_air
mass_concentration_of_water_in_ambient_aerosol_in_air	mass_concentration_of_water_in_ambient_aerosol_particles_in_air
mass_fraction_of_ammonium_dry_aerosol_in_air	mass_fraction_of_ammonium_dry_aerosol_particles_in_air
mass_fraction_of_dust_dry_aerosol_in_air	mass_fraction_of_dust_dry_aerosol_particles_in_air
mass_fraction_of_nitrate_dry_aerosol_in_air	mass_fraction_of_nitrate_dry_aerosol_particles_in_air
mass_fraction_of_nitric_acid_trihydrate_ambient_aerosol_in_air	mass_fraction_of_nitric_acid_trihydrate_ambient_aerosol_particles_in_air
mass_fraction_of_secondary_particulate_organic_matter_dry_aerosol_in_air	mass_fraction_of_secondary_particulate_organic_matter_dry_aerosol_particles_in_air
mass_fraction_of_sulfate_dry_aerosol_in_air	mass_fraction_of_sulfate_dry_aerosol_particles_in_air
mass_fraction_of_water_in_ambient_aerosol_in_air	mass_fraction_of_water_in_ambient_aerosol_particles_in_air
mole_concentration_of_nitric_acid_trihydrate_ambient_aerosol_in_air	mole_concentration_of_nitric_acid_trihydrate_ambient_aerosol_particles_in_air
mole_fraction_of_nitric_acid_trihydrate_ambient_aerosol_in_air	mole_fraction_of_nitric_acid_trihydrate_ambient_aerosol_particles_in_air
number_concentration_of_ambient_aerosol_in_air	number_concentration_of_ambient_aerosol_particles_in_air
number_concentration_of_coarse_mode_ambient_aerosol_in_air	number_concentration_of_coarse_mode_ambient_aerosol_particles_in_air
number_concentration_of_nucleation_mode_ambient_aerosol_in_air	number_concentration_of_nucleation_mode_ambient_aerosol_particles_in_air
optical_thickness_of_atmosphere_layer_due_to_ambient_aerosol	optical_thickness_of_atmosphere_layer_due_to_ambient_aerosol_particles
optical_thickness_of_atmosphere_layer_due_to_aerosol	optical_thickness_of_atmosphere_layer_due_to_ambient_aerosol_particles
tendency_of_atmosphere_mass_content_of_ammonium_dry_aerosol_due_to_dry_deposition	tendency_of_atmosphere_mass_content_of_ammonium_dry_aerosol_particles_due_to_dry_deposition
tendency_of_atmosphere_mass_content_of_ammonium_dry_aerosol_due_to_wet_deposition	tendency_of_atmosphere_mass_content_of_ammonium_dry_aerosol_particles_due_to_wet_deposition
tendency_of_atmosphere_mass_content_of_dust_dry_aerosol_due_to_dry_deposition	tendency_of_atmosphere_mass_content_of_dust_dry_aerosol_particles_due_to_dry_deposition
tendency_of_atmosphere_mass_content_of_dust_dry_aerosol_due_to_gravitational_settling	tendency_of_atmosphere_mass_content_of_dust_dry_aerosol_particles_due_to_gravitational_settling
tendency_of_atmosphere_mass_content_of_dust_dry_aerosol_due_to_turbulent_deposition	tendency_of_atmosphere_mass_content_of_dust_dry_aerosol_particles_due_to_turbulent_deposition
tendency_of_atmosphere_mass_content_of_dust_dry_aerosol_due_to_wet_deposition	tendency_of_atmosphere_mass_content_of_dust_dry_aerosol_particles_due_to_wet_deposition
tendency_of_atmosphere_mass_content_of_mercury_dry_aerosol_due_to_dry_deposition	tendency_of_atmosphere_mass_content_of_mercury_dry_aerosol_particles_due_to_dry_deposition
tendency_of_atmosphere_mass_content_of_mercury_dry_aerosol_due_to_wet_deposition	tendency_of_atmosphere_mass_content_of_mercury_dry_aerosol_particles_due_to_wet_deposition
tendency_of_atmosphere_mass_content_of_nitrate_dry_aerosol_due_to_dry_deposition	tendency_of_atmosphere_mass_content_of_nitrate_dry_aerosol_particles_due_to_dry_deposition
tendency_of_atmosphere_mass_content_of_secondary_particulate_organic_matter_dry_aerosol_due_to_dry_deposition	tendency_of_atmosphere_mass_content_of_secondary_particulate_organic_matter_dry_aerosol_particles_due_to_dry_deposition
tendency_of_atmosphere_mass_content_of_secondary_particulate_organic_matter_dry_aerosol_due_to_net_chemical_production	tendency_of_atmosphere_mass_content_of_secondary_particulate_organic_matter_dry_aerosol_particles_due_to_net_chemical_production
tendency_of_atmosphere_mass_content_of_secondary_particulate_organic_matter_dry_aerosol_due_to_net_production	tendency_of_atmosphere_mass_content_of_secondary_particulate_organic_matter_dry_aerosol_particles_due_to_net_chemical_production
tendency_of_atmosphere_mass_content_of_secondary_particulate_organic_matter_dry_aerosol_due_to_wet_deposition	tendency_of_atmosphere_mass_content_of_secondary_particulate_organic_matter_dry_aerosol_particles_due_to_wet_deposition
tendency_of_atmosphere_mass_content_of_sulfate_dry_aerosol_due_to_dry_deposition	tendency_of_atmosphere_mass_content_of_sulfate_dry_aerosol_particles_due_to_dry_deposition
tendency_of_atmosphere_mass_content_of_sulfate_dry_aerosol_expressed_as_sulfur_due_to_dry_deposition	tendency_of_atmosphere_mass_content_of_sulfate_dry_aerosol_particles_expressed_as_sulfur_due_to_dry_deposition
tendency_of_atmosphere_mass_content_of_sulfate_expressed_as_sulfur_dry_aerosol_due_to_dry_deposition	tendency_of_atmosphere_mass_content_of_sulfate_dry_aerosol_particles_expressed_as_sulfur_due_to_dry_deposition
tendency_of_atmosphere_mass_content_of_sulfate_dry_aerosol_expressed_as_sulfur_due_to_gravitational_settling	tendency_of_atmosphere_mass_content_of_sulfate_dry_aerosol_particles_expressed_as_sulfur_due_to_gravitational_settling
tendency_of_atmosphere_mass_content_of_sulfate_expressed_as_sulfur_dry_aerosol_due_to_gravitational_settling	tendency_of_atmosphere_mass_content_of_sulfate_dry_aerosol_particles_expressed_as_sulfur_due_to_gravitational_settling
tendency_of_atmosphere_mass_content_of_sulfate_dry_aerosol_expressed_as_sulfur_due_to_turbulent_deposition	tendency_of_atmosphere_mass_content_of_sulfate_dry_aerosol_particles_expressed_as_sulfur_due_to_turbulent_deposition
tendency_of_atmosphere_mass_content_of_sulfate_expressed_as_sulfur_dry_aerosol_due_to_turbulent_deposition	tendency_of_atmosphere_mass_content_of_sulfate_dry_aerosol_particles_expressed_as_sulfur_due_to_turbulent_deposition
tendency_of_atmosphere_moles_of_nitric_acid_trihydrate_ambient_aerosol	tendency_of_atmosphere_moles_of_nitric_acid_trihydrate_ambient_aerosol_particles
tendency_of_atmosphere_moles_of_sulfate_dry_aerosol	tendency_of_atmosphere_moles_of_sulfate_dry_aerosol_particles
tendency_of_atmosphere_mass_content_of_sulfate_dry_aerosol_due_to_emission	tendency_of_atmosphere_mass_content_of_sulfate_dry_aerosol_particles_due_to_emission
tendency_of_atmosphere_mass_content_of_dust_dry_aerosol_due_to_emission	tendency_of_atmosphere_mass_content_of_dust_dry_aerosol_particles_due_to_emission
tendency_of_atmosphere_mass_content_of_particulate_organic_matter_dry_aerosol_expressed_as_carbon_due_to_emission_from_residential_and_commercial_combustion	tendency_of_atmosphere_mass_content_of_particulate_organic_matter_dry_aerosol_particles_expressed_as_carbon_due_to_emission_from_residential_and_commercial_combustion
tendency_of_atmosphere_mass_content_of_particulate_organic_matter_dry_aerosol_expressed_as_carbon_due_to_emission_from_waste_treatment_and_disposal	tendency_of_atmosphere_mass_content_of_particulate_organic_matter_dry_aerosol_particles_expressed_as_carbon_due_to_emission_from_waste_treatment_and_disposal
tendency_of_atmosphere_mass_content_of_particulate_organic_matter_dry_aerosol_expressed_as_carbon_due_to_emission_from_savanna_and_grassland_fires	tendency_of_atmosphere_mass_content_of_particulate_organic_matter_dry_aerosol_particles_expressed_as_carbon_due_to_emission_from_savanna_and_grassland_fires
tendency_of_atmosphere_mass_content_of_primary_particulate_organic_matter_dry_aerosol_due_to_emission	tendency_of_atmosphere_mass_content_of_primary_particulate_organic_matter_dry_aerosol_particles_due_to_emission
tendency_of_atmosphere_mass_content_of_particulate_organic_matter_dry_aerosol_expressed_as_carbon_due_to_emission_from_land_transport	tendency_of_atmosphere_mass_content_of_particulate_organic_matter_dry_aerosol_particles_expressed_as_carbon_due_to_emission_from_land_transport
tendency_of_atmosphere_mass_content_of_particulate_organic_matter_dry_aerosol_expressed_as_carbon_due_to_emission_from_agricultural_waste_burning	tendency_of_atmosphere_mass_content_of_particulate_organic_matter_dry_aerosol_particles_expressed_as_carbon_due_to_emission_from_agricultural_waste_burning
tendency_of_atmosphere_mass_content_of_particulate_organic_matter_dry_aerosol_expressed_as_carbon_due_to_emission_from_energy_production_and_distribution	tendency_of_atmosphere_mass_content_of_particulate_organic_matter_dry_aerosol_particles_expressed_as_carbon_due_to_emission_from_energy_production_and_distribution
tendency_of_atmosphere_mass_content_of_particulate_organic_matter_dry_aerosol_expressed_as_carbon_due_to_emission_from_maritime_transport	tendency_of_atmosphere_mass_content_of_particulate_organic_matter_dry_aerosol_particles_expressed_as_carbon_due_to_emission_from_maritime_transport
tendency_of_atmosphere_mass_content_of_particulate_organic_matter_dry_aerosol_due_to_net_chemical_production_and_emission	tendency_of_atmosphere_mass_content_of_particulate_organic_matter_dry_aerosol_particles_due_to_net_chemical_production_and_emission
tendency_of_atmosphere_mass_content_of_particulate_organic_matter_dry_aerosol_due_to_net_production_and_emission	tendency_of_atmosphere_mass_content_of_particulate_organic_matter_dry_aerosol_particles_due_to_net_chemical_production_and_emission
tendency_of_atmosphere_mass_content_of_particulate_organic_matter_dry_aerosol_expressed_as_carbon_due_to_emission_from_forest_fires	tendency_of_atmosphere_mass_content_of_particulate_organic_matter_dry_aerosol_particles_expressed_as_carbon_due_to_emission_from_forest_fires
tendency_of_atmosphere_mass_content_of_particulate_organic_matter_dry_aerosol_expressed_as_carbon_due_to_emission_from_industrial_processes_and_combustion	tendency_of_atmosphere_mass_content_of_particulate_organic_matter_dry_aerosol_particles_expressed_as_carbon_due_to_emission_from_industrial_processes_and_combustion
significant_height_of_swell_waves	sea_surface_swell_wave_significant_height
significant_height_of_wind_waves	sea_surface_wind_wave_significant_height
significant_height_of_wind_and_swell_waves	sea_surface_wave_significant_height
moisture_content_of_soil_layer	mass_content_of_water_in_soil_layer
soil_moisture_content	mass_content_of_water_in_soil
direction_of_swell_wave_velocity	sea_surface_swell_wave_to_direction
direction_of_wind_wave_velocity	sea_surface_wind_wave_to_direction
sea_surface_wave_zero_upcrossing_period	sea_surface_wave_mean_period
sea_surface_wind_wave_zero_upcrossing_period	sea_surface_wind_wave_mean_period
sea_surface_swell_wave_zero_upcrossing_period	sea_surface_swell_wave_mean_period
ocean_mixed_layer_thickness_defined_by_vertical_tracer_diffusivity	ocean_mixed_layer_thickness_defined_by_vertical_tracer_diffusivity_deficit
atmosphere_mass_content_of_seasalt_dry_aerosol_particles	atmosphere_mass_content_of_sea_salt_dry_aerosol_particles
atmosphere_mass_content_of_seasalt_dry_aerosol	atmosphere_mass_content_of_sea_salt_dry_aerosol_particles
atmosphere_optical_thickness_due_to_seasalt_ambient_aerosol_particles	atmosphere_optical_thickness_due_to_sea_salt_ambient_aerosol_particles
atmosphere_optical_thickness_due_to_seasalt_ambient_aerosol	atmosphere_optical_thickness_due_to_sea_salt_ambient_aerosol_particles
mass_concentration_of_seasalt_dry_aerosol_particles_in_air	mass_concentration_of_sea_salt_dry_aerosol_particles_in_air
mass_concentration_of_seasalt_dry_aerosol_in_air	mass_concentration_of_sea_salt_dry_aerosol_particles_in_air
mass_fraction_of_seasalt_dry_aerosol_particles_in_air	mass_fraction_of_sea_salt_dry_aerosol_particles_in_air
mass_fraction_of_seasalt_dry_aerosol_in_air	mass_fraction_of_sea_salt_dry_aerosol_particles_in_air
tendency_of_atmosphere_mass_content_of_pm10_seasalt_dry_aerosol_particles_due_to_dry_deposition	tendency_of_atmosphere_mass_content_of_pm10_sea_salt_dry_aerosol_particles_due_to_dry_deposition
tendency_of_atmosphere_mass_content_of_pm10_seasalt_dry_aerosol_particles_due_to_emission	tendency_of_atmosphere_mass_content_of_pm10_sea_salt_dry_aerosol_particles_due_to_emission
tendency_of_atmosphere_mass_content_of_pm10_seasalt_dry_aerosol_particles_due_to_wet_deposition	tendency_of_atmosphere_mass_content_of_pm10_sea_salt_dry_aerosol_particles_due_to_wet_deposition
tendency_of_atmosphere_mass_content_of_pm2p5_seasalt_dry_aerosol_particles_due_to_wet_deposition	tendency_of_atmosphere_mass_content_of_pm2p5_sea_salt_dry_aerosol_particles_due_to_wet_deposition
tendency_of_atmosphere_mass_content_of_seasalt_dry_aerosol_particles_due_to_dry_deposition	tendency_of_atmosphere_mass_content_of_sea_salt_dry_aerosol_particles_due_to_dry_deposition
tendency_of_atmosphere_mass_content_of_seasalt_dry_aerosol_due_to_dry_deposition	tendency_of_atmosphere_mass_content_of_sea_salt_dry_aerosol_particles_due_to_dry_deposition
tendency_of_atmosphere_mass_content_of_seasalt_dry_aerosol_particles_due_to_gravitational_settling	tendency_of_atmosphere_mass_content_of_sea_salt_dry_aerosol_particles_due_to_gravitational_settling
tendency_of_atmosphere_mass_content_of_seasalt_dry_aerosol_due_to_gravitational_settling	tendency_of_atmosphere_mass_content_of_sea_salt_dry_aerosol_particles_due_to_gravitational_settling
tendency_of_atmosphere_mass_content_of_seasalt_dry_aerosol_particles_due_to_turbulent_deposition	tendency_of_atmosphere_mass_content_of_sea_salt_dry_aerosol_particles_due_to_turbulent_deposition
tendency_of_atmosphere_mass_content_of_seasalt_dry_aerosol_due_to_turbulent_deposition	tendency_of_atmosphere_mass_content_of_sea_salt_dry_aerosol_particles_due_to_turbulent_deposition
tendency_of_atmosphere_mass_content_of_seasalt_dry_aerosol_particles_due_to_wet_deposition	tendency_of_atmosphere_mass_content_of_sea_salt_dry_aerosol_particles_due_to_wet_deposition
tendency_of_atmosphere_mass_content_of_seasalt_dry_aerosol_due_to_wet_deposition	tendency_of_atmosphere_mass_content_of_sea_salt_dry_aerosol_particles_due_to_wet_deposition
atmosphere_optical_thickness_due_to_pm1_ambient_aerosol	atmosphere_optical_thickness_due_to_pm1_ambient_aerosol_particles
mass_concentration_of_pm1_ambient_aerosol_in_air	mass_concentration_of_pm1_ambient_aerosol_particles_in_air
mass_fraction_of_pm1_ambient_aerosol_in_air	mass_fraction_of_pm1_ambient_aerosol_particles_in_air
mass_fraction_of_pm1_aerosol_in_air	mass_fraction_of_pm1_ambient_aerosol_particles_in_air
atmosphere_optical_thickness_due_to_pm2p5_ambient_aerosol	atmosphere_optical_thickness_due_to_pm2p5_ambient_aerosol_particles
mass_concentration_of_pm2p5_ambient_aerosol_in_air	mass_concentration_of_pm2p5_ambient_aerosol_particles_in_air
mass_fraction_of_pm2p5_ambient_aerosol_in_air	mass_fraction_of_pm2p5_ambient_aerosol_particles_in_air
mass_fraction_of_pm2p5_aerosol_in_air	mass_fraction_of_pm2p5_ambient_aerosol_particles_in_air
atmosphere_optical_thickness_due_to_pm10_ambient_aerosol	atmosphere_optical_thickness_due_to_pm10_ambient_aerosol_particles
mass_concentration_of_pm10_ambient_aerosol_in_air	mass_concentration_of_pm10_ambient_aerosol_particles_in_air
mass_fraction_of_pm10_ambient_aerosol_in_air	mass_fraction_of_pm10_ambient_aerosol_particles_in_air
mass_fraction_of_pm10_aerosol_in_air	mass_fraction_of_pm10_ambient_aerosol_particles_in_air
tendency_of_atmosphere_mass_content_of_pm2p5_seasalt_dry_aerosol_particles_due_to_dry_deposition	tendency_of_atmosphere_mass_content_of_pm2p5_sea_salt_dry_aerosol_particles_due_to_dry_deposition
tendency_of_atmosphere_mass_content_of_pm2p5_seasalt_dry_aerosol_particles_due_to_emission	tendency_of_atmosphere_mass_content_of_pm2p5_sea_salt_dry_aerosol_particles_due_to_emission
sea_floor_depth_below_sea_level	sea_floor_depth_below_mean_sea_level
sea_surface_height_above_sea_level	sea_surface_height_above_mean_sea_level
sea_surface_height	sea_surface_height_above_mean_sea_level
surface_geostrophic_eastward_sea_water_velocity_assuming_sea_level_for_geoid	surface_geostrophic_eastward_sea_water_velocity_assuming_mean_sea_level_for_geoid
surface_eastward_geostrophic_sea_water_velocity_assuming_sea_level_for_geoid	surface_geostrophic_eastward_sea_water_velocity_assuming_mean_sea_level_for_geoid
surface_geostrophic_northward_sea_water_velocity_assuming_sea_level_for_geoid	surface_geostrophic_northward_sea_water_velocity_assuming_mean_sea_level_for_geoid
surface_northward_geostrophic_sea_water_velocity_assuming_sea_level_for_geoid	surface_geostrophic_northward_sea_water_velocity_assuming_mean_sea_level_for_geoid
surface_geostrophic_sea_water_x_velocity_assuming_sea_level_for_geoid	surface_geostrophic_sea_water_x_velocity_assuming_mean_sea_level_for_geoid
surface_geostrophic_sea_water_y_velocity_assuming_sea_level_for_geoid	surface_geostrophic_sea_water_y_velocity_assuming_mean_sea_level_for_geoid
tendency_of_sea_surface_height_above_sea_level	tendency_of_sea_surface_height_above_mean_sea_level
surface_northward_geostrophic_sea_water_velocity	surface_geostrophic_northward_sea_water_velocity
surface_eastward_geostrophic_sea_water_velocity	surface_geostrophic_eastward_sea_water_velocity
tendency_of_atmosphere_mass_content_of_nitrogen_due_to_dry_deposition	tendency_of_atmosphere_mass_content_of_nitrogen_compounds_expressed_as_nitrogen_due_to_dry_deposition
tendency_of_atmosphere_mass_content_of_nitrogen_due_to_deposition	tendency_of_atmosphere_mass_content_of_nitrogen_compounds_expressed_as_nitrogen_due_to_deposition
atmosphere_absorption_optical_thickness_due_to_seasalt_ambient_aerosol_particles	atmosphere_absorption_optical_thickness_due_to_sea_salt_ambient_aerosol_particles
atmosphere_absorption_optical_thickness_due_to_seasalt_ambient_aerosol	atmosphere_absorption_optical_thickness_due_to_sea_salt_ambient_aerosol_particles
tendency_of_atmosphere_mass_content_of_seasalt_dry_aerosol_particles_due_to_emission	tendency_of_atmosphere_mass_content_of_sea_salt_dry_aerosol_particles_due_to_emission
tendency_of_atmosphere_mass_content_of_seasalt_dry_aerosol_due_to_emission	tendency_of_atmosphere_mass_content_of_sea_salt_dry_aerosol_particles_due_to_emission
sea_surface_elevation_anomaly	sea_surface_height_above_geoid
sea_surface_elevation	sea_surface_height_above_geoid
sea_floor_depth	sea_floor_depth_below_geoid
air_pressure_at_sea_level	air_pressure_at_mean_sea_level
omega	lagrangian_tendency_of_air_pressure
vertical_air_velocity_expressed_as_tendency_of_pressure	lagrangian_tendency_of_air_pressure
mass_concentration_of_black_carbon_dry_aerosol_in_air	mass_concentration_of_elemental_carbon_dry_aerosol_particles_in_air
atmosphere_mass_content_of_black_carbon_dry_aerosol	atmosphere_mass_content_of_elemental_carbon_dry_aerosol_particles
mass_fraction_of_black_carbon_dry_aerosol_in_air	mass_fraction_of_elemental_carbon_dry_aerosol_particles_in_air
tendency_of_atmosphere_mass_content_of_black_carbon_dry_aerosol_due_to_dry_deposition	tendency_of_atmosphere_mass_content_of_elemental_carbon_dry_aerosol_particles_due_to_dry_deposition
tendency_of_atmosphere_mass_content_of_black_carbon_dry_aerosol_due_to_emission	tendency_of_atmosphere_mass_content_of_elemental_carbon_dry_aerosol_particles_due_to_emission
tendency_of_atmosphere_mass_content_of_black_carbon_dry_aerosol_due_to_emission_from_energy_production_and_distribution	tendency_of_atmosphere_mass_content_of_elemental_carbon_dry_aerosol_particles_due_to_emission_from_energy_production_and_distribution
tendency_of_atmosphere_mass_content_of_black_carbon_dry_aerosol_due_to_emission_from_forest_fires	tendency_of_atmosphere_mass_content_of_elemental_carbon_dry_aerosol_particles_due_to_emission_from_forest_fires
tendency_of_atmosphere_mass_content_of_black_carbon_dry_aerosol_due_to_emission_from_industrial_processes_and_combustion	tendency_of_atmosphere_mass_content_of_elemental_carbon_dry_aerosol_particles_due_to_emission_from_industrial_processes_and_combustion
tendency_of_atmosphere_mass_content_of_black_carbon_dry_aerosol_due_to_emission_from_land_transport	tendency_of_atmosphere_mass_content_of_elemental_carbon_dry_aerosol_particles_due_to_emission_from_land_transport
tendency_of_atmosphere_mass_content_of_black_carbon_dry_aerosol_due_to_emission_from_maritime_transport	tendency_of_atmosphere_mass_content_of_elemental_carbon_dry_aerosol_particles_due_to_emission_from_maritime_transport
tendency_of_atmosphere_mass_content_of_black_carbon_dry_aerosol_due_to_emission_from_residential_and_commercial_combustion	tendency_of_atmosphere_mass_content_of_elemental_carbon_dry_aerosol_particles_due_to_emission_from_residential_and_commercial_combustion
tendency_of_atmosphere_mass_content_of_black_carbon_dry_aerosol_due_to_emission_from_savanna_and_grassland_fires	tendency_of_atmosphere_mass_content_of_elemental_carbon_dry_aerosol_particles_due_to_emission_from_savanna_and_grassland_fires
tendency_of_atmosphere_mass_content_of_black_carbon_dry_aerosol_due_to_emission_from_waste_treatment_and_disposal	tendency_of_atmosphere_mass_content_of_elemental_carbon_dry_aerosol_particles_due_to_emission_from_waste_treatment_and_disposal
tendency_of_atmosphere_mass_content_of_black_carbon_dry_aerosol_due_to_gravitational_settling	tendency_of_atmosphere_mass_content_of_elemental_carbon_dry_aerosol_particles_due_to_gravitational_settling
tendency_of_atmosphere_mass_content_of_black_carbon_dry_aerosol_due_to_turbulent_deposition	tendency_of_atmosphere_mass_content_of_elemental_carbon_dry_aerosol_particles_due_to_turbulent_deposition
tendency_of_atmosphere_mass_content_of_black_carbon_dry_aerosol_due_to_wet_deposition	tendency_of_atmosphere_mass_content_of_elemental_carbon_dry_aerosol_particles_due_to_wet_deposition
tendency_of_mass_concentration_of_black_carbon_dry_aerosol_in_air_due_to_emission_from_aviation	tendency_of_mass_concentration_of_elemental_carbon_dry_aerosol_particles_in_air_due_to_emission_from_aviation
integral_of_surface_downward_latent_heat_flux_wrt_time	integral_wrt_time_of_surface_downward_latent_heat_flux
integral_of_surface_downward_sensible_heat_flux_wrt_time	integral_wrt_time_of_surface_downward_sensible_heat_flux
integral_of_surface_net_downward_longwave_flux_wrt_time	integral_wrt_time_of_surface_net_downward_longwave_flux
integral_of_surface_net_downward_shortwave_flux_wrt_time	integral_wrt_time_of_surface_net_downward_shortwave_flux
integral_of_toa_net_downward_shortwave_flux_wrt_time	integral_wrt_time_of_toa_net_downward_shortwave_flux
integral_of_toa_outgoing_longwave_flux_wrt_time	integral_wrt_time_of_toa_outgoing_longwave_flux
northward_ocean_freshwater_transport_due_to_bolus_advection	northward_ocean_freshwater_transport_due_to_parameterized_eddy_advection
northward_ocean_salt_transport_due_to_bolus_advection	northward_ocean_salt_transport_due_to_parameterized_eddy_advection
ocean_heat_x_transport_due_to_bolus_advection	ocean_heat_x_transport_due_to_parameterized_eddy_advection
ocean_heat_y_transport_due_to_bolus_advection	ocean_heat_y_transport_due_to_parameterized_eddy_advection
ocean_mass_x_transport_due_to_advection_and_bolus_advection	ocean_mass_x_transport_due_to_advection_and_parameterized_eddy_advection
ocean_mass_y_transport_due_to_advection_and_bolus_advection	ocean_mass_y_transport_due_to_advection_and_parameterized_eddy_advection
ocean_meridional_overturning_mass_streamfunction_due_to_bolus_advection	ocean_meridional_overturning_mass_streamfunction_due_to_parameterized_eddy_advection
ocean_y_overturning_mass_streamfunction_due_to_bolus_advection	ocean_y_overturning_mass_streamfunction_due_to_parameterized_eddy_advection
tendency_of_sea_water_salinity_due_to_bolus_advection	tendency_of_sea_water_salinity_due_to_parameterized_eddy_advection
bolus_northward_sea_water_velocity	northward_sea_water_velocity_due_to_parameterized_mesoscale_eddies
bolus_eastward_sea_water_velocity	eastward_sea_water_velocity_due_to_parameterized_mesoscale_eddies
bolus_sea_water_x_velocity	sea_water_x_velocity_due_to_parameterized_mesoscale_eddies
bolus_sea_water_y_velocity	sea_water_y_velocity_due_to_parameterized_mesoscale_eddies
bolus_upward_sea_water_velocity	upward_sea_water_velocity_due_to_parameterized_mesoscale_eddies
ocean_tracer_bolus_biharmonic_diffusivity	ocean_tracer_biharmonic_diffusivity_due_to_parameterized_mesoscale_eddy_advection
ocean_tracer_bolus_laplacian_diffusivity	ocean_tracer_laplacian_diffusivity_due_to_parameterized_mesoscale_eddy_advection
tendency_of_ocean_eddy_kinetic_energy_content_due_to_bolus_transport	tendency_of_ocean_eddy_kinetic_energy_content_due_to_parameterized_eddy_advection
northward_ocean_heat_transport_due_to_bolus_advection	northward_ocean_heat_transport_due_to_parameterized_eddy_advection
mole_concentration_of_dissolved_inorganic_carbon13_in_sea_water	mole_concentration_of_dissolved_inorganic_13C_in_sea_water
surface_downward_mass_flux_of_carbon13_dioxide_abiotic_analogue_expressed_as_carbon13	surface_downward_mass_flux_of_13C_dioxide_abiotic_analogue_expressed_as_13C
surface_downward_mass_flux_of_carbon14_dioxide_abiotic_analogue_expressed_as_carbon	surface_downward_mass_flux_of_14C_dioxide_abiotic_analogue_expressed_as_carbon
mole_concentration_of_dissolved_inorganic_carbon14_in_sea_water	mole_concentration_of_dissolved_inorganic_14C_in_sea_water
wood_carbon_content	stem_mass_content_of_carbon
subsurface_litter_carbon_content	subsurface_litter_mass_content_of_carbon
litter_carbon_flux	mass_flux_of_carbon_into_litter_from_vegetation
litter_carbon_content	litter_mass_content_of_carbon
surface_litter_carbon_content	surface_litter_mass_content_of_carbon
eastward_transformed_eulerian_mean_velocity	eastward_transformed_eulerian_mean_air_velocity
northward_transformed_eulerian_mean_velocity	northward_transformed_eulerian_mean_air_velocity
heterotrophic_respiration_carbon_flux	surface_upward_mass_flux_of_carbon_dioxide_expressed_as_carbon_due_to_heterotrophic_respiration
soil_respiration_carbon_flux	surface_upward_mass_flux_of_carbon_dioxide_expressed_as_carbon_due_to_respiration_in_soil
plant_respiration_carbon_flux	surface_upward_mass_flux_of_carbon_dioxide_expressed_as_carbon_due_to_plant_respiration
surface_upward_carbon_mass_flux_due_to_plant_respiration_for_biomass_growth	surface_upward_mass_flux_of_carbon_dioxide_expressed_as_carbon_due_to_plant_respiration_for_biomass_growth
surface_upward_carbon_mass_flux_due_to_plant_respiration_for_biomass_maintenance	surface_upward_mass_flux_of_carbon_dioxide_expressed_as_carbon_due_to_plant_respiration_for_biomass_maintenance
carbon_content_of_forestry_and_agricultural_products	carbon_mass_content_of_forestry_and_agricultural_products
carbon_content_of_products_of_anthropogenic_land_use_change	carbon_mass_content_of_forestry_and_agricultural_products
leaf_carbon_content	leaf_mass_content_of_carbon
medium_soil_pool_carbon_content	medium_soil_pool_mass_content_of_carbon
fast_soil_pool_carbon_content	fast_soil_pool_mass_content_of_carbon
miscellaneous_living_matter_carbon_content	miscellaneous_living_matter_mass_content_of_carbon
root_carbon_content	root_mass_content_of_carbon
slow_soil_pool_carbon_content	slow_soil_pool_mass_content_of_carbon
soil_carbon_content	soil_mass_content_of_carbon
volume_scattering_coefficient_in_air_due_to_dried_aerosol_particles	volume_scattering_coefficient_of_radiative_flux_in_air_due_to_dried_aerosol_particles
volume_scattering_coefficient_in_air_due_to_ambient_aerosol_particles	volume_scattering_coefficient_of_radiative_flux_in_air_due_to_ambient_aerosol_particles
integral_of_sea_water_practical_salinity_wrt_depth	integral_wrt_depth_of_sea_water_practical_salinity
integral_of_product_of_eastward_wind_and_specific_humidity_wrt_height	integral_wrt_height_of_product_of_eastward_wind_and_specific_humidity
integral_of_product_of_northward_wind_and_specific_humidity_wrt_height	integral_wrt_height_of_product_of_northward_wind_and_specific_humidity
water_flux_into_ocean_from_rivers	water_flux_into_sea_water_from_rivers
toa_outgoing_shortwave_flux_assuming_clean_clear_sky	toa_outgoing_shortwave_flux_assuming_clear_sky_and_no_aerosol
wood_debris_carbon_content	wood_debris_mass_content_of_carbon
large_scale_graupel_flux	stratiform_graupel_flux
water_volume_transport_into_ocean_from_rivers	water_volume_transport_into_sea_water_from_rivers
water_evaporation_flux_where_sea_ice	surface_water_evaporation_flux
integral_wrt_depth_of_sea_ice_temperature_expressed_as_heat_content	sea_ice_temperature_expressed_as_heat_content
integral_of_sea_ice_temperature_wrt_depth_expressed_as_heat_content	sea_ice_temperature_expressed_as_heat_content
river_water_volume_transport_into_cell	incoming_water_volume_transport_along_river_channel
surface_upwelling_longwave_flux	surface_upwelling_longwave_flux_in_air
surface_upwelling_spectral_radiance_in_air	surface_upwelling_radiance_per_unit_wavelength_in_air
surface_upwelling_spectral_radiance_in_air_emerging_from_sea_water	surface_upwelling_radiance_per_unit_wavelength_in_air_emerging_from_sea_water
surface_upwelling_spectral_radiance_in_air_reflected_by_sea_water	surface_upwelling_radiance_per_unit_wavelength_in_air_reflected_by_sea_water
surface_upwelling_spectral_radiance_in_sea_water	surface_upwelling_radiance_per_unit_wavelength_in_sea_water
surface_upwelling_spectral_radiative_flux_in_air	surface_upwelling_radiative_flux_per_unit_wavelength_in_air
surface_upwelling_spectral_radiative_flux_in_sea_water	surface_upwelling_radiative_flux_per_unit_wavelength_in_sea_water
surface_upwelling_shortwave_flux	surface_upwelling_shortwave_flux_in_air
surface_upwelling_shortwave_flux_in_air_assuming_clean_clear_sky	surface_upwelling_shortwave_flux_in_air_assuming_clear_sky_and_no_aerosol
upwelling_spectral_radiance_in_air	upwelling_radiance_per_unit_wavelength_in_air
upwelling_spectral_radiative_flux_in_air	upwelling_radiative_flux_per_unit_wavelength_in_air
upwelling_spectral_radiative_flux_in_sea_water	upwelling_radiative_flux_per_unit_wavelength_in_sea_water
upwelling_shortwave_flux_in_air_assuming_clean_clear_sky	upwelling_shortwave_flux_in_air_assuming_clear_sky_and_no_aerosol
surface_upwelling_longwave_flux_assuming_clear_sky	surface_upwelling_longwave_flux_in_air_assuming_clear_sky
surface_upwelling_shortwave_flux_assuming_clear_sky	surface_upwelling_shortwave_flux_in_air_assuming_clear_sky
downwelling_spectral_photon_flux_in_sea_water	downwelling_photon_flux_per_unit_wavelength_in_sea_water
downwelling_spectral_photon_radiance_in_sea_water	downwelling_photon_radiance_per_unit_wavelength_in_sea_water
downwelling_spectral_photon_spherical_irradiance_in_sea_water	downwelling_photon_spherical_irradiance_per_unit_wavelength_in_sea_water
downwelling_spectral_radiance_in_air	downwelling_radiance_per_unit_wavelength_in_air
downwelling_spectral_radiance_in_sea_water	downwelling_radiance_per_unit_wavelength_in_sea_water
downwelling_spectral_radiative_flux_in_air	downwelling_radiative_flux_per_unit_wavelength_in_air
downwelling_spectral_radiative_flux_in_sea_water	downwelling_radiative_flux_per_unit_wavelength_in_sea_water
downwelling_shortwave_flux_in_air_assuming_clean_clear_sky	downwelling_shortwave_flux_in_air_assuming_clear_sky_and_no_aerosol
downwelling_spectral_spherical_irradiance_in_sea_water	downwelling_spherical_irradiance_per_unit_wavelength_in_sea_water
integral_of_surface_downwelling_longwave_flux_in_air_wrt_time	integral_wrt_time_of_surface_downwelling_longwave_flux_in_air
integral_of_surface_downwelling_shortwave_flux_in_air_wrt_time	integral_wrt_time_of_surface_downwelling_shortwave_flux_in_air
surface_downwelling_longwave_flux	surface_downwelling_longwave_flux_in_air
surface_downwelling_spectral_photon_flux_in_sea_water	surface_downwelling_photon_flux_per_unit_wavelength_in_sea_water
surface_downwelling_spectral_photon_radiance_in_sea_water	surface_downwelling_photon_radiance_per_unit_wavelength_in_sea_water
surface_downwelling_spectral_photon_spherical_irradiance_in_sea_water	surface_downwelling_photon_spherical_irradiance_per_unit_wavelength_in_sea_water
surface_downwelling_spectral_radiance_in_sea_water	surface_downwelling_radiance_per_unit_wavelength_in_sea_water
surface_downwelling_spectral_radiative_flux_in_air	surface_downwelling_radiative_flux_per_unit_wavelength_in_air
surface_downwelling_spectral_radiative_flux_in_sea_water	surface_downwelling_radiative_flux_per_unit_wavelength_in_sea_water
surface_downwelling_shortwave_flux	surface_downwelling_shortwave_flux_in_air
surface_downwelling_shortwave_flux_assuming_clear_sky	surface_downwelling_shortwave_flux_in_air_assuming_clear_sky
surface_downwelling_shortwave_flux_in_air_assuming_clean_clear_sky	surface_downwelling_shortwave_flux_in_air_assuming_clear_sky_and_no_aerosol
surface_downwelling_spectral_spherical_irradiance_in_sea_water	surface_downwelling_spherical_irradiance_per_unit_wavelength_in_sea_water
sea_ice_displacement	magnitude_of_sea_ice_displacement
tendency_of_sea_ice_amount_due_to_snow_conversion	tendency_of_sea_ice_amount_due_to_conversion_of_snow_to_sea_ice
river_water_volume_transport_out_of_cell	outgoing_water_volume_transport_along_river_channel
precipitation_flux_onto_canopy_where_land	precipitation_flux_onto_canopy
water_evaporation_flux_from_canopy_where_land	water_evaporation_flux_from_canopy
water_evaporation_amount_from_canopy_where_land	water_evaporation_amount_from_canopy
convective_precipitation_rate	lwe_convective_precipitation_rate
lwe_large_scale_precipitation_rate	lwe_stratiform_precipitation_rate
lwe_thickness_of_large_scale_precipitation_amount	lwe_thickness_of_stratiform_precipitation_amount
large_scale_precipitation_amount	stratiform_precipitation_amount
large_scale_precipitation_flux	stratiform_precipitation_flux
tendency_of_specific_humidity_due_to_large_scale_precipitation	tendency_of_specific_humidity_due_to_stratiform_precipitation
platform_roll_angle	platform_roll
platform_pitch_angle	platform_pitch
platform_yaw_angle	platform_yaw
station_wmo_id	platform_id
station_description	platform_name
water_vapor_pressure	water_vapor_partial_pressure_in_air
tendency_of_atmosphere_of_mole_concentration_of_carbon_monoxide_due_to_chemical_destruction	tendency_of_atmosphere_mole_concentration_of_carbon_monoxide_due_to_chemical_destruction
tendency_of_mole_concentration_of_dissolved_inorganic_phosphate_in_sea_water_due_to_biological_processes	tendency_of_mole_concentration_of_dissolved_inorganic_phosphorus_in_sea_water_due_to_biological_processes
tendency_of_mole_concentration_of_dissolved_inorganic_silicate_in_sea_water_due_to_biological_processes	tendency_of_mole_concentration_of_dissolved_inorganic_silicon_in_sea_water_due_to_biological_processes
mole_concentration_of_diatoms_in_sea_water_expressed_as_nitrogen	mole_concentration_of_diatoms_expressed_as_nitrogen_in_sea_water
net_primary_mole_productivity_of_carbon_by_calcareous_phytoplankton	net_primary_mole_productivity_of_biomass_expressed_as_carbon_by_calcareous_phytoplankton
net_primary_mole_productivity_of_carbon_by_diatoms	net_primary_mole_productivity_of_biomass_expressed_as_carbon_by_diatoms
net_primary_mole_productivity_of_carbon_by_phytoplankton	net_primary_mole_productivity_of_biomass_expressed_as_carbon_by_phytoplankton
net_primary_mole_productivity_of_carbon_by_picophytoplankton	net_primary_mole_productivity_of_biomass_expressed_as_carbon_by_picophytoplankton
net_primary_mole_productivity_of_carbon_due_to_nitrate_utilization	net_primary_mole_productivity_of_biomass_expressed_as_carbon_due_to_nitrate_utilization
mole_concentration_of_phytoplankton_in_sea_water_expressed_as_nitrogen	mole_concentration_of_phytoplankton_expressed_as_nitrogen_in_sea_water
tendency_of_atmosphere_mass_content_of_nitrogen_due_to_wet_deposition	tendency_of_atmosphere_mass_content_of_nitrogen_compounds_expressed_as_nitrogen_due_to_wet_deposition
tendency_of_moles_of_carbon_monoxide_in_atmosphere	tendency_of_atmosphere_moles_of_carbon_monoxide
tendency_of_moles_of_carbon_tetrachloride_in_atmosphere	tendency_of_atmosphere_moles_of_carbon_tetrachloride
tendency_of_atmosphere_mass_content_of_black_carbon_dry_aerosol_due_to_emission_from_agricultural_waste_burning	tendency_of_atmosphere_mass_content_of_elemental_carbon_dry_aerosol_particles_due_to_emission_from_agricultural_waste_burning
water_vapor_saturation_deficit	water_vapor_saturation_deficit_in_air
mole_fraction_of_total_inorganic_bromine_in_air	mole_fraction_of_inorganic_bromine_in_air
net_primary_mole_productivity_of_carbon_by_miscellaneous_phytoplankton	net_primary_mole_productivity_of_biomass_expressed_as_carbon_by_miscellaneous_phytoplankton
tendency_of_moles_of_methane_in_atmosphere	tendency_of_atmosphere_moles_of_methane
mole_fraction_of_total_reactive_nitrogen_in_air	mole_fraction_of_noy_expressed_as_nitrogen_in_air
mole_fraction_of_methlyglyoxal_in_air	mole_fraction_of_methylglyoxal_in_air
moles_of_carbon_tetrachloride_in_atmosphere	atmosphere_moles_of_carbon_tetrachloride
tendency_of_atmosphere_mass_content_of_sulfate_dry_aerosol_expressed_as_sulfur_due_to_wet_deposition	tendency_of_atmosphere_mass_content_of_sulfate_dry_aerosol_particles_expressed_as_sulfur_due_to_wet_deposition
tendency_of_atmosphere_mass_content_of_sulfate_expressed_as_sulfur_dry_aerosol_due_to_wet_deposition	tendency_of_atmosphere_mass_content_of_sulfate_dry_aerosol_particles_expressed_as_sulfur_due_to_wet_deposition
mass_fraction_of_mercury_dry_aerosol_in_air	mass_fraction_of_mercury_dry_aerosol_particles_in_air
tendency_of_atmosphere_mass_content_of_mercury_dry_aerosol_due_to_emission	tendency_of_atmosphere_mass_content_of_mercury_dry_aerosol_particles_due_to_emission
carbon_mass_flux_into_soil_and_litter_due_to_anthropogenic_land_use_or_land_cover_change	carbon_mass_flux_into_litter_and_soil_due_to_anthropogenic_land_use_or_land_cover_change
product_of_eastward_wind_and_omega	product_of_eastward_wind_and_lagrangian_tendency_of_air_pressure
product_of_northward_wind_and_omega	product_of_northward_wind_and_lagrangian_tendency_of_air_pressure
backscattering_ratio	backscattering_ratio_in_air
histogram_of_backscattering_ratio_over_height_above_reference_ellipsoid	histogram_of_backscattering_ratio_in_air_over_height_above_reference_ellipsoid
effective_radius_of_convective_cloud_ice_particle	effective_radius_of_convective_cloud_ice_particles
effective_radius_of_convective_cloud_rain_particle	effective_radius_of_convective_cloud_rain_particles
effective_radius_of_convective_cloud_snow_particle	effective_radius_of_convective_cloud_snow_particles
effective_radius_of_stratiform_cloud_graupel_particle	effective_radius_of_stratiform_cloud_graupel_particles
effective_radius_of_stratiform_cloud_ice_particle	effective_radius_of_stratiform_cloud_ice_particles
effective_radius_of_stratiform_cloud_rain_particle	effective_radius_of_stratiform_cloud_rain_particles
mass_concentration_of_biomass_burning_dry_aerosol_in_air	mass_concentration_of_biomass_burning_dry_aerosol_particles_in_air
ambient_aerosol_particle_diameter	diameter_of_ambient_aerosol_particles
electrical_mobility_particle_diameter	electrical_mobility_diameter_of_ambient_aerosol_particles
upward_air_velocity_expressed_as_tendency_of_sigma	lagrangian_tendency_of_atmosphere_sigma_coordinate
vertical_air_velocity_expressed_as_tendency_of_sigma	lagrangian_tendency_of_atmosphere_sigma_coordinate
tendency_of_atmosphere_number_content_of_aerosol_particles_due_to_turbulent_depostion	tendency_of_atmosphere_number_content_of_aerosol_particles_due_to_turbulent_deposition
moles_of_hcfc22_in_atmosphere	atmosphere_moles_of_hcfc22
tendency_of_moles_of_hcfc22_in_atmosphere	tendency_of_atmosphere_moles_of_hcfc22
tendency_of_moles_of_hcfc22_in_troposphere	tendency_of_troposphere_moles_of_hcfc22
tendency_of_moles_of_hcc140a_in_middle_atmosphere	tendency_of_middle_atmosphere_moles_of_hcc140a
tendency_of_moles_of_hcc140a_in_troposphere	tendency_of_troposphere_moles_of_hcc140a
moles_of_hcc140a_in_atmosphere	atmosphere_moles_of_hcc140a
tendency_of_moles_of_hcc140a_in_atmosphere	tendency_of_atmosphere_moles_of_hcc140a
moles_of_halon2402_in_atmosphere	atmosphere_moles_of_halon2402
tendency_of_moles_of_halon2402_in_atmosphere	tendency_of_atmosphere_moles_of_halon2402
moles_of_halon1301_in_atmosphere	atmosphere_moles_of_halon1301
tendency_of_moles_of_halon1301_in_atmosphere	tendency_of_atmosphere_moles_of_halon1301
moles_of_halon1211_in_atmosphere	atmosphere_moles_of_halon1211
tendency_of_moles_of_halon1211_in_atmosphere	tendency_of_atmosphere_moles_of_halon1211
moles_of_halon1202_in_atmosphere	atmosphere_moles_of_halon1202
tendency_of_moles_of_halon1202_in_atmosphere	tendency_of_atmosphere_moles_of_halon1202
moles_of_cfc12_in_atmosphere	atmosphere_moles_of_cfc12
tendency_of_moles_of_cfc12_in_atmosphere	tendency_of_atmosphere_moles_of_cfc12
moles_of_cfc115_in_atmosphere	atmosphere_moles_of_cfc115
tendency_of_moles_of_cfc115_in_atmosphere	tendency_of_atmosphere_moles_of_cfc115
moles_of_cfc114_in_atmosphere	atmosphere_moles_of_cfc114
tendency_of_moles_of_cfc114_in_atmosphere	tendency_of_atmosphere_moles_of_cfc114
moles_of_cfc113_in_atmosphere	atmosphere_moles_of_cfc113
tendency_of_moles_of_cfc113_in_atmosphere	tendency_of_atmosphere_moles_of_cfc113
moles_of_cfc11_in_atmosphere	atmosphere_moles_of_cfc11
moles_per_unit_mass_of_cfc11_in_sea_water	moles_of_cfc11_per_unit_mass_in_sea_water
tendency_of_moles_of_cfc11_in_atmosphere	tendency_of_atmosphere_moles_of_cfc11
effective_radius_of_stratiform_cloud_snow_particle	effective_radius_of_stratiform_cloud_snow_particles
product_of_geopotential_height_and_omega	product_of_lagrangian_tendency_of_air_pressure_and_geopotential_height
product_of_omega_and_specific_humidity	product_of_lagrangian_tendency_of_air_pressure_and_specific_humidity
product_of_specific_humidity_and_omega	product_of_lagrangian_tendency_of_air_pressure_and_specific_humidity
volume_fraction_of_water_in_soil	volume_fraction_of_condensed_water_in_soil
volume_fraction_of_water_in_soil_at_critical_point	volume_fraction_of_condensed_water_in_soil_at_critical_point
volume_fraction_of_water_in_soil_at_field_capacity	volume_fraction_of_condensed_water_in_soil_at_field_capacity
volume_fraction_of_water_in_soil_at_wilting_point	volume_fraction_of_condensed_water_in_soil_at_wilting_point
integral_wrt_depth_of_product_of_sea_water_density_and_salinity	integral_wrt_depth_of_product_of_salinity_and_sea_water_density
sea_water_to_direction	sea_water_velocity_to_direction
direction_of_sea_water_velocity	sea_water_velocity_to_direction
sea_water_from_direction	sea_water_velocity_from_direction
atmosphere_cloud_liquid_water_content	atmosphere_mass_content_of_cloud_liquid_water
effective_radius_of_cloud_liquid_water_particle	effective_radius_of_cloud_liquid_water_particles
effective_radius_of_convective_cloud_liquid_water_particle	effective_radius_of_convective_cloud_liquid_water_particles
effective_radius_of_convective_cloud_liquid_water_particle_at_convective_liquid_water_cloud_top	effective_radius_of_convective_cloud_liquid_water_particles_at_convective_liquid_water_cloud_top
effective_radius_of_stratiform_cloud_liquid_water_particle	effective_radius_of_stratiform_cloud_liquid_water_particles
effective_radius_of_stratiform_cloud_liquid_water_particle_at_stratiform_liquid_water_cloud_top	effective_radius_of_stratiform_cloud_liquid_water_particles_at_stratiform_liquid_water_cloud_top
number_concentration_of_convective_cloud_liquid_water_particle_at_convective_liquid_water_cloud_top	number_concentration_of_convective_cloud_liquid_water_particles_at_convective_liquid_water_cloud_top
number_concentration_of_stratiform_cloud_liquid_water_particle_at_stratiform_liquid_water_cloud_top	number_concentration_of_stratiform_cloud_liquid_water_particles_at_stratiform_liquid_water_cloud_top
cloud_liquid_water_content_of_atmosphere_layer	mass_content_of_cloud_liquid_water_in_atmosphere_layer
effective_radius_of_cloud_liquid_water_particle_at_liquid_water_cloud_top	effective_radius_of_cloud_liquid_water_particles_at_liquid_water_cloud_top
atmosphere_convective_cloud_liquid_water_content	atmosphere_mass_content_of_convective_cloud_liquid_water
tendency_of_mass_fraction_of_stratiform_cloud_ice_in_air_due_to_riming_from_cloud_liquid	tendency_of_mass_fraction_of_stratiform_cloud_ice_in_air_due_to_riming_from_cloud_liquid_water
tendency_of_mass_fraction_of_stratiform_cloud_ice_in_air_due_to_heterogeneous_nucleation_from_cloud_liquid	tendency_of_mass_fraction_of_stratiform_cloud_ice_in_air_due_to_heterogeneous_nucleation_from_cloud_liquid_water
tendency_of_mass_fraction_of_stratiform_cloud_ice_in_air_due_to_melting_to_cloud_liquid	tendency_of_mass_fraction_of_stratiform_cloud_ice_in_air_due_to_melting_to_cloud_liquid_water
growth_limitation_of_diazotrophs_due_to_solar_irradiance	growth_limitation_of_diazotrophic_phytoplankton_due_to_solar_irradiance
iron_growth_limitation_of_diazotrophs	iron_growth_limitation_of_diazotrophic_phytoplankton
mass_concentration_of_diazotrophs_expressed_as_chlorophyll_in_sea_water	mass_concentration_of_diazotrophic_phytoplankton_expressed_as_chlorophyll_in_sea_water
mole_concentration_of_diazotrophs_expressed_as_carbon_in_sea_water	mole_concentration_of_diazotrophic_phytoplankton_expressed_as_carbon_in_sea_water
net_primary_mole_productivity_of_biomass_expressed_as_carbon_by_diazotrophs	net_primary_mole_productivity_of_biomass_expressed_as_carbon_by_diazotrophic_phytoplankton
net_primary_mole_productivity_of_carbon_by_diazotrophs	net_primary_mole_productivity_of_biomass_expressed_as_carbon_by_diazotrophic_phytoplankton
nitrogen_growth_limitation_of_diazotrophs	nitrogen_growth_limitation_of_diazotrophic_phytoplankton
tendency_of_mole_concentration_of_particulate_organic_matter_expressed_as_carbon_in_sea_water_due_to_net_primary_production_by_diazotrophs	tendency_of_mole_concentration_of_particulate_organic_matter_expressed_as_carbon_in_sea_water_due_to_net_primary_production_by_diazotrophic_phytoplankton
mass_fraction_of_rain_and_drizzle_in_air	mass_fraction_of_liquid_precipitation_in_air
mass_fraction_of_rain_in_air	mass_fraction_of_liquid_precipitation_in_air
land_cover	area_type
surface_cover	area_type
eastward_wind_shear	upward_derivative_of_eastward_wind
northward_wind_shear	upward_derivative_of_northward_wind
atmosphere_absolute_vorticity	atmosphere_upward_absolute_vorticity
atmosphere_relative_vorticity	atmosphere_upward_relative_vorticity
snow_density	surface_snow_density
surface_snow_and_ice_sublimation_flux	tendency_of_atmosphere_mass_content_of_water_vapor_due_to_sublimation_of_surface_snow_and_ice
integral_of_surface_downward_northward_stress_wrt_time	integral_wrt_time_of_surface_downward_northward_stress
integral_of_surface_downward_eastward_stress_wrt_time	integral_wrt_time_of_surface_downward_eastward_stress
snow_thermal_energy_content	thermal_energy_content_of_surface_snow
surface_snow_thickness_where_sea_ice	surface_snow_thickness
liquid_water_content_of_snow_layer	liquid_water_content_of_surface_snow
snow_soot_content	soot_content_of_surface_snow
biological_taxon_identifier	biological_taxon_lsid
water_evaporation_flux	water_evapotranspiration_flux
vertical_drainage_amount_in_soil	drainage_amount_through_base_of_soil_model
moles_of_particulate_inorganic_carbon_per_unit_mass_of_sea_water	moles_of_particulate_inorganic_carbon_per_unit_mass_in_sea_water
water_flux_correction	water_flux_into_sea_water_due_to_flux_adjustment
heat_flux_correction	heat_flux_into_sea_water_due_to_flux_adjustment
volume_backwards_scattering_coefficient_in_air_due_to_dried_aerosol_particles	volume_backwards_scattering_coefficient_of_radiative_flux_in_air_due_to_dried_aerosol_particles
volume_extinction_coefficient_in_air_due_to_ambient_aerosol_particles	volume_extinction_coefficient_of_radiative_flux_in_air_due_to_ambient_aerosol_particles
volume_extinction_coefficient_in_air_due_to_ambient_aerosol	volume_extinction_coefficient_of_radiative_flux_in_air_due_to_ambient_aerosol_particles
volume_extinction_coefficient_in_air_due_to_cloud_particles	volume_extinction_coefficient_of_radiative_flux_in_air_due_to_cloud_particles
volume_attenuated_backwards_scattering_function_in_air_assuming_no_aerosol_or_cloud	volume_attenuated_backwards_scattering_coefficient_of_radiative_flux_in_air_assuming_no_aerosol_or_cloud
volume_attenuated_backwards_scattering_function_in_air	volume_attenuated_backwards_scattering_coefficient_of_radiative_flux_in_air
volume_absorption_coefficient_in_air_due_to_dried_aerosol_particles	volume_absorption_coefficient_of_radiative_flux_in_air_due_to_dried_aerosol_particles
equivalent_temperature	air_equivalent_temperature
equivalent_potential_temperature	air_equivalent_potential_temperature
pseudo_equivalent_potential_temperature	air_pseudo_equivalent_potential_temperature
pseudo_equivalent_temperature	air_pseudo_equivalent_temperature
surface_temperature_where_land	surface_temperature
surface_temperature_where_open_sea	surface_temperature
surface_temperature_where_snow	surface_temperature
solid_earth_subsurface_temperature	temperature_in_ground
snow_temperature	temperature_in_surface_snow
integral_wrt_depth_of_product_of_sea_water_density_and_conservative_temperature	integral_wrt_depth_of_product_of_conservative_temperature_and_sea_water_density
integral_wrt_depth_of_product_of_sea_water_density_and_potential_temperature	integral_wrt_depth_of_product_of_potential_temperature_and_sea_water_density
integral_wrt_depth_of_sea_water_temperature_in_ocean_layer	integral_wrt_depth_of_sea_water_temperature
ocean_integral_wrt_depth_of_sea_water_temperature	integral_wrt_depth_of_sea_water_temperature
integral_of_sea_water_temperature_wrt_depth_in_ocean_layer	integral_wrt_depth_of_sea_water_temperature
ocean_integral_of_sea_water_temperature_wrt_depth	integral_wrt_depth_of_sea_water_temperature
universal_thermal_climate_index	universal_thermal_comfort_index
product_of_omega_and_air_temperature	product_of_lagrangian_tendency_of_air_pressure_and_air_temperature
product_of_air_temperature_and_omega	product_of_lagrangian_tendency_of_air_pressure_and_air_temperature
integral_of_air_temperature_deficit_wrt_time	integral_wrt_time_of_air_temperature_deficit
integral_of_air_temperature_excess_wrt_time	integral_wrt_time_of_air_temperature_excess
tendency_of_air_temperature_due_to_large_scale_precipitation	tendency_of_air_temperature_due_to_stratiform_precipitation
tendency_of_sea_water_temperature_due_to_bolus_advection	tendency_of_sea_water_temperature_due_to_parameterized_eddy_advection
upward_geothermal_heat_flux_at_ground_level_in_land_ice	upward_heat_flux_at_base_of_grounded_ice_sheet
ocean_volume_fraction	sea_water_volume_fraction
large_scale_cloud_area_fraction	stratiform_cloud_area_fraction
floating_ice_sheet_area_fraction	floating_ice_shelf_area_fraction
photolysis_rate_of_ozone_to_1D_oxygen_atom	photolysis_rate_of_ozone_to_atomic_singlet_oxygen
sea_water_potential_temperature_expressed_as_heat_content	integral_wrt_depth_of_sea_water_potential_temperature_expressed_as_heat_content
integral_of_sea_water_potential_temperature_wrt_depth_expressed_as_heat_content	integral_wrt_depth_of_sea_water_potential_temperature_expressed_as_heat_content
tendency_of_sea_water_potential_temperature_expressed_as_heat_content	tendency_of_integral_wrt_depth_of_sea_water_potential_temperature_expressed_as_heat_content
tendency_of_sea_water_potential_temperature_expressed_as_heat_content_due_to_parameterized_dianeutral_mixing	tendency_of_integral_wrt_depth_of_sea_water_potential_temperature_expressed_as_heat_content_due_to_parameterized_dianeutral_mixing
tendency_of_sea_water_potential_temperature_expressed_as_heat_content_due_to_parameterized_eddy_dianeutral_mixing	tendency_of_integral_wrt_depth_of_sea_water_potential_temperature_expressed_as_heat_content_due_to_parameterized_dianeutral_mixing
tendency_of_sea_water_potential_temperature_expressed_as_heat_content_due_to_parameterized_eddy_advection	tendency_of_integral_wrt_depth_of_sea_water_potential_temperature_expressed_as_heat_content_due_to_parameterized_eddy_advection
tendency_of_sea_water_potential_temperature_expressed_as_heat_content_due_to_parameterized_mesoscale_eddy_advection	tendency_of_integral_wrt_depth_of_sea_water_potential_temperature_expressed_as_heat_content_due_to_parameterized_mesoscale_eddy_advection
tendency_of_sea_water_potential_temperature_expressed_as_heat_content_due_to_parameterized_mesoscale_eddy_diffusion	tendency_of_integral_wrt_depth_of_sea_water_potential_temperature_expressed_as_heat_content_due_to_parameterized_mesoscale_eddy_diffusion
tendency_of_sea_water_potential_temperature_expressed_as_heat_content_due_to_parameterized_submesoscale_eddy_advection	tendency_of_integral_wrt_depth_of_sea_water_potential_temperature_expressed_as_heat_content_due_to_parameterized_submesoscale_eddy_advection
tendency_of_sea_water_potential_temperature_expressed_as_heat_content_due_to_residual_mean_advection	tendency_of_integral_wrt_depth_of_sea_water_potential_temperature_expressed_as_heat_content_due_to_residual_mean_advection
tendency_of_sea_water_salinity_expressed_as_salt_content_due_to_parameterized_eddy_advection	tendency_of_integral_wrt_depth_of_sea_water_salinity_expressed_as_salt_mass_content_due_to_parameterized_eddy_advection
tendency_of_sea_water_salinity_expressed_as_salt_content	tendency_of_integral_wrt_depth_of_sea_water_salinity_expressed_as_salt_mass_content
tendency_of_sea_water_salinity_expressed_as_salt_content_due_to_parameterized_dianeutral_mixing	tendency_of_integral_wrt_depth_of_sea_water_salinity_expressed_as_salt_mass_content_due_to_parameterized_dianeutral_mixing
tendency_of_sea_water_salinity_expressed_as_salt_content_due_to_parameterized_eddy_dianeutral_mixing	tendency_of_integral_wrt_depth_of_sea_water_salinity_expressed_as_salt_mass_content_due_to_parameterized_dianeutral_mixing
tendency_of_sea_water_salinity_expressed_as_salt_content_due_to_parameterized_mesoscale_eddy_advection	tendency_of_integral_wrt_depth_of_sea_water_salinity_expressed_as_salt_mass_content_due_to_parameterized_mesoscale_eddy_advection
tendency_of_sea_water_salinity_expressed_as_salt_content_due_to_parameterized_mesoscale_eddy_diffusion	tendency_of_integral_wrt_depth_of_sea_water_salinity_expressed_as_salt_mass_content_due_to_parameterized_mesoscale_eddy_diffusion
tendency_of_sea_water_salinity_expressed_as_salt_content_due_to_parameterized_submesoscale_eddy_advection	tendency_of_integral_wrt_depth_of_sea_water_salinity_expressed_as_salt_mass_content_due_to_parameterized_submesoscale_eddy_advection
tendency_of_sea_water_salinity_expressed_as_salt_content_due_to_residual_mean_advection	tendency_of_integral_wrt_depth_of_sea_water_salinity_expressed_as_salt_mass_content_due_to_residual_mean_advection
tendency_of_sea_water_conservative_temperature_expressed_as_heat_content_due_to_parameterized_dianeutral_mixing	tendency_of_integral_wrt_depth_of_sea_water_conservative_temperature_expressed_as_heat_content_due_to_parameterized_dianeutral_mixing
tendency_of_sea_water_conservative_temperature_expressed_as_heat_content_due_to_parameterized_eddy_dianeutral_mixing	tendency_of_integral_wrt_depth_of_sea_water_conservative_temperature_expressed_as_heat_content_due_to_parameterized_dianeutral_mixing
tendency_of_sea_water_conservative_temperature_expressed_as_heat_content_due_to_parameterized_mesoscale_eddy_diffusion	tendency_of_integral_wrt_depth_of_sea_water_conservative_temperature_expressed_as_heat_content_due_to_parameterized_mesoscale_eddy_diffusion
tendency_of_sea_water_conservative_temperature_expressed_as_heat_content_due_to_parameterized_mesoscale_eddy_advection	tendency_of_integral_wrt_depth_of_sea_water_conservative_temperature_expressed_as_heat_content_due_to_parameterized_mesoscale_eddy_advection
tendency_of_sea_water_conservative_temperature_expressed_as_heat_content	tendency_of_integral_wrt_depth_of_sea_water_conservative_temperature_expressed_as_heat_content
tendency_of_sea_water_conservative_temperature_expressed_as_heat_content_due_to_residual_mean_advection	tendency_of_integral_wrt_depth_of_sea_water_conservative_temperature_expressed_as_heat_content_due_to_residual_mean_advection
tendency_of_sea_water_conservative_temperature_expressed_as_heat_content_due_to_parameterized_submesoscale_eddy_advection	tendency_of_integral_wrt_depth_of_sea_water_conservative_temperature_expressed_as_heat_content_due_to_parameterized_submesoscale_eddy_advection
tendency_of_sea_water_conservative_temperature_expressed_as_heat_content_due_to_parameterized_eddy_advection	tendency_of_integral_wrt_depth_of_sea_water_conservative_temperature_expressed_as_heat_content_due_to_parameterized_eddy_advection
vegetation_carbon_content	vegetation_mass_content_of_carbon
